Play = Играть
Ratings = Рейтинги
SelectGame = ВЫБРАТЬ ИГРУ
Wheel = Рулетка
Shop = Магазин
Bonus = Бонус
Login = Войти
EnterLogin = введите логин...
EnterPassword = введите пароль...
LoginWithGoogle = Войти через Google
Registration = Регистрация
LoginWithApple = Войти через Apple
Logout = Выйти
RepeatPassword = повторите пароль...
Sound = Звук
Language = Язык
FieldIsEmpty = пустое поле
UserExists = пользователь с таким логином уже существует
WrongLoginOrPassword = неверный логин или пароль
LoginFail = вход не выполнен. попробуйте позде
MaxNameLength = максимальная длина в имени: 20 символов
PasswordsDoNotMatch = пароли не совпадают
NameIsUnavailable = имя недоступно
Loading = загрузка
Day = День
Tomorrow = Завтра
MoneySymbol = ₽
WatchAd = Смотреть рекламу
Best = Лучший
Spin = Вращать
DailyBonus = ежедневный бонус
WheelOfFortune = колесо удачи
Exchange = Обмен
For = на
Reset = сброс
OrGoTo = или перейти в
