Play = Jogar
Ratings = Avaliações
SelectGame = SELECIONE O JOGO
Wheel = Roda
Shop = Loja
Bonus = Bonus
Login = Login
EnterLogin = insira o login ...
EnterPassword = digite a senha...
LoginWithGoogle = Entrar com o Google
Registration = Cadastro
LoginWithApple = Entrar com o Apple
Logout = Sair
RepeatPassword = repita a senha...
Sound = Som
Language = Língua
FieldIsEmpty = campo está vazio
UserExists = usuário com este login já existe
WrongLoginOrPassword = login ou senha errada
LoginFail = falha de login. tente mais tarde
MaxNameLength = comprimento máximo do nome: 20 símbolos
PasswordsDoNotMatch = as senhas não coincidem
NameIsUnavailable = nome indisponível
Loading = carregando
Day = dia
Tomorrow = Amanhã
MoneySymbol = €
WatchAd = Assistir a anúncios
Best = Melhor:
Spin = Girar
DailyBonus = Bônus diário
WheelOfFortune = roda da fortuna
Exchange = Troca
For = por
Reset = redefinir
OrGoTo = ou vá para
Register = Registrar agora
YourReward = sua recompensa:
Get = pegue
